1111111111111111
1P00010001010001
1C00CCCCC1010001
1CCCC100C1CCC001
10000100CCC1CCE1
1111111111111111
