11111111111111111
1P0C0000000000001
1P0C00000E0000001
11111111111111111
