11111111111111111111111111111111111
100000000000000CCC000000000000000E1
1C11111111111010C0101111111111111C1
1000000000000010C010000000000000001
1011111111111000C000111111111111101
1000000000000010C010000000000000001
1P11111111111010C010111111111111101
100C0C0C0C0C0CCCCCCC0C0C0C0C0C0C001
11111111111111111111111111111111111
